###################
#  .        . . . #
#    #####   #    #
#    # . #   #    #
#    #   #   # .  #
#    #   ####     #
# .  #    .       #
###################